sc,sz,sz,sz,sz,sz,sz,sz,sz,sz,sz,sz,sz,sz,sz,sz,sz,sz,sz,sz,sz
sx,b1,b1,b1,b1,b1,b1,b2,b2,b2,b2,b2,b3,b3,b3,b3,b3,b4,b4,b4,b4
sx,b1,b1,b1,b1,b1,b1,b2,b2,b2,b2,b2,b3,b3,b3,b3,b3,b4,b4,b4,b4
sx,b1,b1,b1,b1,b1,b1,b2,b2,b2,b2,b2,b3,b3,b3,b3,b3,b4,b4,b4,b4
sx,b1,b1,b1,b1,b1,b1,b2,b2,b2,b2,b2,b3,b3,b3,b3,b3,b4,b4,b4,b4
sx,b5,b5,b5,b5,pl,pl,pl,pl,pl,pl,pl,pl,pl,pl,pl,pl,b4,b4,b4,b4
sx,b5,b5,b5,b5,pl,pl,pl,pl,pl,pl,pl,pl,pl,pl,pl,pl,b4,b4,b4,b4
sx,b5,b5,b5,b5,pl,pl,pl,pl,pl,pl,pl,pl,pl,pl,pl,pl,b4,b4,b4,b4
sx,b5,b5,b5,b5,pl,pl,pl,pl,pl,pl,pl,pl,pl,pl,pl,pl,b4,b4,b4,b4
sx,b5,b5,b5,b5,pl,pl,pl,pl,pl,pl,pl,pl,pl,pl,pl,pl,b6,b6,b6,b6
sx,b5,b5,b5,b5,pl,pl,pl,pl,pl,pl,pl,pl,pl,pl,pl,pl,b6,b6,b6,b6
sx,b5,b5,b5,b5,pl,pl,pl,pl,pl,pl,pl,pl,pl,pl,pl,pl,b6,b6,b6,b6
sx,b7,b7,b7,b7,pl,pl,pl,pl,pl,pl,pl,pl,pl,pl,pl,pl,b6,b6,b6,b6
sx,b7,b7,b7,b7,pl,pl,pl,pl,pl,pl,pl,pl,pl,pl,pl,pl,b6,b6,b6,b6
sx,b7,b7,b7,b7,pl,pl,pl,pl,pl,pl,pl,pl,pl,pl,pl,pl,b6,b6,b6,b6
sx,b7,b7,b7,b7,pl,pl,pl,pl,pl,pl,pl,pl,pl,pl,pl,pl,b6,b6,b6,b6
sx,b7,b7,b7,b7,b8,b8,b8,b8,b8,b8,b8,b8,b9,b9,b9,b9,b9,b9,b9,b9
sx,b7,b7,b7,b7,b8,b8,b8,b8,b8,b8,b8,b8,b9,b9,b9,b9,b9,b9,b9,b9
sx,b7,b7,b7,b7,b8,b8,b8,b8,b8,b8,b8,b8,b9,b9,b9,b9,b9,b9,b9,b9
sx,b7,b7,b7,b7,b8,b8,b8,b8,b8,b8,b8,b8,b9,b9,b9,b9,b9,b9,b9,b9