sc,sz,sz,sz,sz,sz,sz,sz,sz,sz,sz,sz,sz,sz,sz,sz,sz,sz,sz,sz,sz
sx,pl,pl,pl,pl,pl,pl,pl,pl,pl,pl,pl,pl,pl,pl,pl,pl,pl,pl,pl,pl
sx,pl,pl,pl,pl,pl,pl,pl,pl,pl,pl,pl,pl,pl,pl,pl,pl,pl,pl,pl,pl
sx,pl,pl,b1,b1,b1,b1,b1,b1,b1,b1,b1,b1,b1,b1,b1,b1,b1,b1,pl,pl
sx,pl,pl,b1,b1,b1,b1,b1,b1,b1,b1,b1,b1,b1,b1,b1,b1,b1,b1,pl,pl
sx,pl,pl,b1,b1,b1,b1,b1,b1,b1,b1,b1,b1,b1,b1,b1,b1,b1,b1,pl,pl
sx,pl,pl,b1,b1,b1,b1,b1,b1,b1,b1,b1,b1,b1,b1,b1,b1,b1,b1,pl,pl
sx,pl,pl,b1,b1,b1,b1,b1,b1,b1,b1,b1,b1,b1,b1,b1,b1,b1,b1,pl,pl
sx,pl,pl,b1,b1,b1,b1,b1,b1,b1,b1,b1,b1,b1,b1,b1,b1,b1,b1,pl,pl
sx,pl,pl,b1,b1,b1,b1,b1,b1,b1,b1,b1,b1,b1,b1,b1,b1,b1,b1,pl,pl
sx,pl,pl,b1,b1,b1,b1,b1,b1,b1,b1,b1,b1,b1,b1,b1,b1,b1,b1,pl,pl
sx,pl,pl,b1,b1,b1,b1,b1,b1,b1,b1,b1,b1,b1,b1,b1,b1,b1,b1,pl,pl
sx,pl,pl,b1,b1,b1,b1,b1,b1,b1,b1,b1,b1,b1,b1,b1,b1,b1,b1,pl,pl
sx,pl,pl,b1,b1,b1,b1,b1,b1,b1,b1,b1,b1,b1,b1,b1,b1,b1,b1,pl,pl
sx,pl,pl,b1,b1,b1,b1,b1,b1,b1,b1,b1,b1,b1,b1,b1,b1,b1,b1,pl,pl
sx,pl,pl,b1,b1,b1,b1,b1,b1,b1,b1,b1,b1,b1,b1,b1,b1,b1,b1,pl,pl
sx,pl,pl,b1,b1,b1,b1,b1,b1,b1,b1,b1,b1,b1,b1,b1,b1,b1,b1,pl,pl
sx,pl,pl,b1,b1,b1,b1,b1,b1,b1,b1,b1,b1,b1,b1,b1,b1,b1,b1,pl,pl
sx,pl,pl,pl,pl,pl,pl,pl,pl,pl,pl,pl,pl,pl,pl,pl,pl,pl,pl,pl,pl
sx,pl,pl,pl,pl,pl,pl,pl,pl,pl,pl,pl,pl,pl,pl,pl,pl,pl,pl,pl,pl